___*****#*******
_B_####*#*******
___**********###
####****#*******
***********#*##*
****#**#***#*#**
#####*##*###*###
******#**#******
******#**#******
###*###*##*#####
**#*#***#**#****
*##*#***********
*******#*#**####
###******#***___
*******#*####_R_
*******#*****___